10 10
0 1 9 7
#0########
#00000####
#####000##
#00000####
#0###0000#
#0###0####
#000000###
##0###0###
##000#00##
#######0##
