10x10
#E########
#00000####
#####000##
#00000####
#0###0000#
#0###0####
#000000###
##0###0###
##000#00##
#######S##