20 20
0 3 5 19
###0################
###0#####0000#######
###0##0000###0000###
###0##0##0###0##0###
###0##0##0###0##0###
###0#####0###0##0000
###0000000###0######
#########0###0######
##000####0###0######
####000000###0000#0#
####0####0######0#0#
#0000####0###0000#0#
#0#######0###0####0#
#0#0000000###0##000#
#0#0#########0##0###
#0#0#######000##00##
#0#000000000#0###0##
#0###########0###0##
#000000000###00000##
####################
