13x40
11 0 12 33
########################################
#####000000000##########000000######00##
#####0#######00000000###0####0#000000###
##00000000###0######0###0####0#0########
##0##########0##000000000000#000########
##0##########0##0#0########0####00000###
##0#0000000##0##0#0000#####0####0###0###
##0#0#####0000##0######0###000000###0###
##0#0###########0######000##########0###
##0#000000####0000000####0##########0###
####0####0####0#####0####0##########0###
00000####000000#####000000#######0000###
#################################0######
